##############################
##############################
##............##............##
##.####.#####.##.#####.####.##
##*####.#####.##.#####.####*##
##.####.#####.##.#####.####.##
##..........................##
##.####.##.########.##.####.##
##.####.##.########.##.####.##
##......##....##....##......##
#######.##### ## #####.#######
#######.##### ## #####.#######
     ##.##    RR    ##.##
#######.## +++--+++ ##.#######
#######.## +      + ##.#######
       .   +BBPPOO+   .
#######.## +      + ##.#######
#######.## ++++++++ ##.#######
     ##.##          ##.##
#######.## ######## ##.#######
#######.## ######## ##.#######
##............##............##
##.####.#####.##.#####.####.##
##.####.#####.##.#####.####.##
##*..##.......PP.......##..*##
####.##.##.########.##.##.####
####.##.##.########.##.##.####
##......##....##....##......##
##.##########.##.##########.##
##.##########.##.##########.##
##..........................##
##############################
##############################
