############################
#............##............#
#.####.#####.##.#####.####.#
#*####.#####.##.#####.####*#
#.####.#####.##.#####.####.#
#..........................#
#.####.##.########.##.####.#
#.####.##.########.##.####.#
#......##....##....##......#
######.##### ## #####.######
######.##### ## #####.######
    ##.##    RR    ##.##
######.## +++--+++ ##.######
######.## +      + ##.######
      .   +BBPPOO+   .
######.## +      + ##.######
######.## ++++++++ ##.######
    ##.##          ##.##
######.## ######## ##.######
######.## ######## ##.######
#............##............#
#.####.#####.##.#####.####.#
#.####.#####.##.#####.####.#
#*..##.......PP.......##..*#
###.##.##.########.##.##.###
###.##.##.########.##.##.###
#......##....##....##......#
#.##########.##.##########.#
#.##########.##.##########.#
#..........................#
############################
